* ****
*    *
*    *
*    *
******